你好(晚上好/早);	今日は.今晩は	1.一般见面问候语
谢(谢了);	今晩は	1.一般见面问候语
早上好;	おはようございます	1.一般见面问候语
再见(5种说法);	じゃね。それでは.じゃまた。それではまた。さようなら。	1.一般见面问候语
对不起对不起了(请问);	すみませんでした。	1.一般见面问候语
抱歉;	ごめんなさい。	1.一般见面问候语
有人在吗?有人在家吗?	ごめんください。	1.一般见面问候语
没关系	どういたしまして。	1.一般见面问候语
每天很忙，要打扫卫生、洗衣服、做饭等。	毎日、掃除とか洗濯とか食事の支度とかでばたばたしています。	50.表达举例分类多2
不用特意去，打电话或者发邮件都行。	わざわざ行かなくても、電話するとかメールを出すとかでいいです。	50.表达举例分类多2
我想参加4天或5天的自由活动的旅游团。	4日間とか5日間の自由行動のツアーに参加したい。	50.表达举例分类多2
被认为脑子好或成绩好什么的，有时候很吃亏。	頭がいいとか成績がいいとか見られるのは損だという場合がある。	50.表达举例分类多2
不要说不干或放弃，再努力一下。	辞めるとか諦めるとか言わないで、もうちょっと頑張ってください。	50.表达举例分类多2
休息日见见朋友或是宅在家什么的。	休日は友達に会ったり、家でごろごろしたりしています。	50.表达举例分类多2
暑假里参加夏令营或是上语言学校学外语什么的。	夏休みには、合宿に参加したり、語学学校に通ったりします。	50.表达举例分类多2
因为工作来往于东京和北京。	仕事の関係で、東京と北京を行ったり来たりしています。	50.表达举例分类多2
温泉能够消除疲劳和治愈疾病等。	温泉は疲れを癒したり病気を治したりできます。	50.表达举例分类多2
时贵时便宜，价格一直在变动。	高かったり安かったりで価格が変動しています。	50.表达举例分类多2
早饭各式各样，有西餐和日餐等。	朝食は洋食だったり和食だったり、いろいろあります。	50.表达举例分类多2
是不是迷路了?	もしかして、道を迷ったりしていますか?	50.表达举例分类多2
不喝点儿茶什么的吗?不喝点儿茶什么的吗?	お茶でも飲みませんか?	50.表达举例分类多2
你是不是感冒了?	風邪でも引きましたか?	50.表达举例分类多2
你是不是发烧了?	熱でもあるの?	50.表达举例分类多2
你是不是身体不舒服?	具合でも悪いの?	50.表达举例分类多2
这哪儿是朋友啊?根本不是朋友。	友達でも何でもない	50.表达举例分类多2
完全不是朋友	全然友達じゃない:	50.表达举例分类多2
绝对不是朋友	全然便利じゃない:完全不方便	50.表达举例分类多2
哪儿方便啊?一点儿都不方便。	全然便利じゃない:	50.表达举例分类多2
完全不方便;绝对不方便。	全然便利じゃない；絶対に便利じゃない	50.表达举例分类多2